#############
#          B#
### ######  #
###  #####  #
####  ####  #
##   #####  #
###  #####  #
A           #
#############
